NO ./textures/colorstone.xpm
SO ./textures/wood.xpm
WE ./textures/mossy.xpm
EA ./textures/mossy.xpm


C 173,200,210
F 100,100,100

1111111111111111111111111111
  1010000000011000000000000111111
  10110000011100000000000011110111
  10010000000000000000000010000000111111
11111 1111101100000111000000000001111101
10000110011000001110111111111111000111111
11110000111111011100000010001   11111111111
1111011111111101110101001000111111111111
110000001101010111000000100011111111111
1000000E000000001100000010001111111111
10000000000000001101010010001
110000011101010111110111100111
11110111111101011101111010011
111111111111111111111111111111

11111111111111111111111111111