NO ./textures/wolf.xpm
SO ./textures/bird.xpm
WE ./textures/fish.xpm
EA ./textures/lion.xpm


F 75,108,87
C 173,216,230

1111111111111111111111111111
1000000000000000000000000001
1000000000000000000000000001
1000000000000000000000000001
100000000000E000000000000001
1000000000000000000000000001
1000000000000000000000000001
1000000000000000000000000001
1000000000000000000000000001
1111111111111111111111111111