NO ./textures/wolf.xpm
SO ./textures/bird.xpm
WE ./textures/fish.xpm
EA ./textures/lion.xpm


F 75,108,87
C 173,216,230

111111111111111
100000000000001
100000000000001
1000000000W0001
100000000000001
100000000000001
100001000000001
100000000000001
100000000000001
111111111111111
