NO ./images/wolfenstein/wood.xpm
SO ./images/wolfenstein/greystone.xpm
WE ./images/wolfenstein/eagle.xpm
EA  ./images/wolfenstein/mossy.xpm

F 112, 112, 112
C 56, 56, 56

        1111111111111111111111111
        1001000000100000000000001
        1011000000100000000000001
        1011000000100000010000001
        1011000000100000010000001
        1011000000100000010000001
        1011000000100000010000001
        1011000N00100000010000001
        1000000000000000010000001
111111111011000001110010010000001
100000000011000001110011111111111
1111011111111101110000001
11111111111111011101001011111
11000000110101011100000010001
10000000000000001100000010001
10000000000000001101010010001
1100000111010101 111011110011
11110111 1110101 101111010001
11111111 1111111 111111111111



